################################
#..............................#
#..............................#
#......####################....#
#......##......................#
#......##......................#
#......##..................#####
###....##......................#
#......##......................#
#......##......................#
#......##......................#
#......##......................#
#....####......................#
#......##......................#
#......##......................#
#......##E.....................#
#P.....##E.....................#
##########LLLLLLLLLLLLLLLLLLLLL#