################################
#..............................#
#..............................#
#..............................#
#..............................#
#..............................#
#..............................#
#..............................#
#P.............................#
###.....##.....##.....##.......#
#..............................#
#..............................#
#..............................#
#..............................#
#..............................#
#.............................E#
#.............................E#
#............................###
#..............................#
#LLLLLLLLLLLLLLLLLLLLLLLLLLLLLL#