################################
#..............................#
#..............................#
#..............................#
#..............................#
#..............................#
#..............................#
#..............................#
#..............................#
#..............................#
#..............................#
#....######################....#
#..............................#
#..............................#
#..............................#
#.............................E#
#P............................E#
########LLLLLLLLLLLLLLLL########